10 10
1 1
8 8
**********
*..**....*
**.*..****
*...*.*.**
*.***.*.**
*...*.*.**
*.*.*.*.**
*.*.*.*.**
*.*.....**
**********

