7 7
1 1
5 3
*******
*.....*
*.***.*
*...*.*
*.*****
*.....*
*******
